6
A.P.W.W.P.W
W.W.W.W.W.W
W.G.W.W.W.W
W.W.P.P.W.W
W.W.W.W.W.W
-.W.W.W.W.W