10
G.-.-.-.-.-.-.-.-.A
-.-.W.W.W.G.P.P.W.-
-.-.-.-.G.-.-.-.-.-
W.W.W.G.W.W.W.G.-.G
-.-.-.-.-.-.-.-.-.-
W.-.P.W.W.-.-.W.W.P
-.-.-.-.G.-.-.-.-.G
G.-.G.W.P.W.G.-.W.P
W.W.-.-.-.-.W.W.W.-
-.-.P.-.G.-.-.-.-.G