5
A.-.-.P.-
-.G.W.G.-
-.W.P.W.-
-.W.P.-.W
-.-.-.-.-