6
A.W.W.W.P.W
W.W.W.W.W.W
W.G.W.W.W.W
W.W.P.P.W.W
W.W.W.W.W.W
-.W.W.W.W.W