10
W.W.P.-.W.-.P.-.-.A
G.-.-.-.-.-.G.-.-.-
P.-.W.-.P.-.W.-.P.-
-.G.-.G.-.-.-.G.-.-
W.-.P.G.W.P.P.-.W.P
-.-.-.-.-.-.-.G.-.-
P.P.W.-.P.G.W.W.P.-
-.-.-.-.-.-.-.-.-.-
W.-.P.P.W.-.P.-.W.P
-.-.-.P.-.-.W.-.-.G
