10
W.W.P.-.W.-.P.-.-.A
G.-.-.-.-.-.G.-.-.-
P.-.W.-.P.-.W.-.P.-
-.G.-.G.-.-.-.G.-.-
W.-.W.G.W.P.P.-.W.P
-.-.-.-.-.-.-.G.-.-
P.W.W.-.P.G.W.W.P.-
-.-.-.-.-.-.-.-.-.-
W.-.W.P.W.-.P.-.W.P
-.-.-.P.-.-.W.-.-.G
