10
-.-.P.-.-.-.-.-.G.P
-.A.W.-.P.P.W.W.-.P
-.-.W.-.-.-.-.W.P.G
W.-.G.-.-.-.-.G.P.-
-.-.-.-.-.-.W.P.-.-
-.-.-.-.-.-.P.-.-.-
-.-.G.-.W.P.P.-.-.-
-.-.-.W.P.-.-.-.W.-
-.-.G.-.P.-.P.W.W.-
-.-.-.-.G.-.P.G.-.-
