10
-.-.-.-.-.-.-.-.-.-
-.W.W.W.W.-.-.P.P.-
-.-.W.G.-.-.P.P.P.-
-.-.G.W.-.P.P.G.P.-
-.-.W.W.-.P.G.P.P.-
-.-.W.G.-.P.-.P.-.-
-.-.G.W.-.-.-.P.P.-
-.-.W.G.-.-.-.-.-.-
-.-.G.W.-.-.W.W.P.-
-.-.W.W.-.P.G.W.-.A
