10
G.-.-.-.-.-.-.-.-.G
-.G.-.-.-.G.-.-.-.-
-.-.W.W.W.W.W.-.-.P
-.-.W.-.-.-.P.-.-.-
-.-.G.-.A.-.W.-.-.W
-.-.W.-.-.-.W.-.-.-
-.-.P.P.W.W.W.-.W.G
W.W.-.G.-.-.-.-.-.W
W.W.W.W.W.W.W.-.P.-
-.-.-.-.-.-.-.-.-.-